    #####          
    #.O #          
    #   #          
  ###  O##         
  #  O O #         
### # ## #   ######
#   # ## #####   .#
# O  O          ..#
##### ### #x##  ..#
    #     #########
    #######        
