########
# O.# .#
#     x#
# OO#O #
#    ..#
########
