############
#   #      #
#   #O#    #
#          #
###    O   #
#     ######
#  x   ..###
############
