###############
#   #   #     #
#####   #     #
#             #
# # # ## ######
#   # ## ##   #
#             #
#  #O## #x#   #
#  #    ###  .#
###############
