##############
#            #
# ######*### #
# # O O O  # #
# # . . ..O# #
# O  ####  # #
# # .#  O.O# #
# #O.#O #* # #
# # .   #.O# #
# # #####  . #
# #O.. . . # #
# #  OxO O # #
# ###*###### #
#            #
##############
