########
#  .# .#
# O   x#
# OO## #
#     .#
########
