##############
#            #
# ###### ### #
# #        # #
# #        # #
# O  ####  # #
# # .#  O O# #
# #  #  #  # #
# #     #. # #
# # #####  . #
# #        # #
# #   x    # #
# ### ###### #
#            #
##############
