###########
#         #
# O       #
###   #.  #
# OO  #.  #
#x   ##.  #
###########
