############
#   #     .#
# O #O#    #
#         O#
###    O   #
#     ######
#  x  ...###
############
