###############
#   #   #     #
#####   #     #
#             #
# #O#O## ######
#   # ## ##   #
#             #
#  #O## #x#   #
#  #    ###...#
###############
