########
#. #   #
#  O   #
#   # ##
## # O.#
#   O  #
#  .# x#
########
