#####
#.O #
#   #
#x  #
#####
