###############
#             #
#x            #
#  O########  #
#   #         #
#   #         #
#   #  ########
#   #         #
#   #        .#
###############
